aaacrimonious - caustic/hostile
consternation - confusion/puzzlement
expurgate - censor/purge
ignoble - disreputable/disrespectful
impugn - belittle/criticize
abate - lessen/diminish
avarice - greed
dilatory - stalling/procrastinating
pretentious - showy/ostentacious
equivocate - unclear/ambiguous
efficacious - effective/efficient
gratuitous - unjustified
recondite - learned/esoteric
reprobate - scoundrel/low-life
sedentary - stationary/unmoving
contingent - conditional/dependant on
discursive - digressive
salient - conspicuous/blatant
satiate - gratify
specious - counterfeit/deceptively plausible
deleterious - harmful/detrimental
extenuate - mitigate/moderate
implicit - unspoken
paragon - ideal/perfect model of
sanctimonious - self-righteous
aver - assert/state openly
encumber - burden/overload
incontrovertible - indisputable
nonplussed - puzzled/perplexed
prolific - productive/fruitful
beneficent - charitable
debase - demean/corrupt
perfidy - treachery/betrayel
disavow - to take back/retract
irresolute - indiscisive
equanimity - calmness/traquility
gauche - uncouth/vulgur
denizen - native/resident
prosaic - commonplace
broach - to bring up 